*************
*...........*
*..***.***..*
*..*........*
**.*******..*
*...........*
****..*******
*...........*
****..****..*
*.....*..*..*
*.*****..*..*
*..*........*
*..*******..*
*..*........*
*..****..*..*
*........*..*
*************
