*************
*...........*
*..*******..*
*..*........*
**********..*
*...........*
****..*******
*...........*
****..****..*
*.....*..*..*
*******..*..*
*..*........*
*..*******..*
*..*........*
*..****..*..*
*........*..*
*..****..*..*
*..*.....*..*
****..****..*
*.....*.....*
*..*******..*
*.....*.....*
*..**********
*...........*
*..**********
*.....*.....*
****..****..*
*..*..*.....*
*..*..*..*..*
*.....*..*..*
*..*******..*
*.....*..*..*
****..*..*..*
*..*........*
*..****..*..*
*..*..*..*..*
*..*..*..****
*...........*
*******..*..*
*..*..*..*..*
*..*..*..*..*
*........*..*
*..*..*******
*..*........*
*******..*..*
*.....*..*..*
****..*..****
*...........*
*..****..*..*
*.....*..*..*
*************
