*************
*...........*
*..*******..*
*..*........*
**********..*
*...........*
****..*******
*...........*
****..****..*
*.....*..*..*
*******..*..*
*..*........*
*..*******..*
*..*........*
*..****..*..*
*........*..*
*************
