*******************
*.................*
*..*..*..*..*..*..*
*..*.....*.....*..*
*.....*.....*.....*
*..*.....*.....*..*
*..*..*..*..*..*..*
*.................*
*******************
