*******************
*.................*
*..*..*..*..*..*..*
*..*..*..*..*..*..*
*..*..*.....*..*..*
*..*..*..*..*..*..*
*..*..*..*..*..*..*
*.................*
*******************
