*******************
*.....*...........*
**.****..*..****..*
*.....*..*..*.....*
*..****..*..*..*..*
*..*..*.....*..*..*
*..*..*..*..****..*
*........*........*
*******************
