*******************
*.....*...........*
**.**.*..*..****..*
*........*..*.....*
*..*..*..*..*..*..*
*..*........*..*..*
*..*..*..*..**.*..*
*........*........*
*******************
