*******************
*.....*...........*
**.****..*..****..*
*.....*..*..*.....*
*..*..*..*..*..*..*
*..*..*.....*..*..*
*..*..*..*..**.*..*
*........*........*
*******************
