
****************************************************************************
*..*........*..*..*..............*...........*.....*.....*.................*
*..****..****..*..*..**********..**********..*..*..*..*******..*******..****
*...........*.................*........*........*.................*..*.....*
****..*..*..****..*..****..****..*******..*******..*..****..*..****..*******
*..*..*..*........*..*........*.....*........*.....*..*..*..*..*..*........*
*..**********..*..*******..*************..****..****..*..*******..*..*..*..*
*..*..*........*.....*.....*.....*.....*..*........*.....*...........*..*..*
*..*..*..*******..**********..*..*..*..*..*..**********..****************..*
*...........*........*........*..*..*..*..*..*.................*.....*..*..*
*..*************..*..*..****..****..****************..*******..*..*..*..*..*
*..*.....*..*..*..*.....*..*..*.....*.....*.....*..*........*..*..*..*..*..*
*..****..*..*..*..*..*..*..*******..****..****..*..*******..*..*..****..*..*
*...........*.....*..*...........*.....*.....*..............*...........*..*
****..**********..*******..**********..*..*************..*******..*..****..*
*..*.....*.....*........*.....*..*........*....................*..*........*
*..*..****..****..**********..*..*..*..*..*******..****..**********..****..*
*...........*..*..*...........*.....*..*........*..*.....*..*...........*..*
*..*..*******..*..*******..*******..**********..*******..*..*..*..****..****
*..*........*..*........*.....*........*..*........*........*..*..*..*.....*
*..****..****..*..*******..****..*******..**********..*******..****..****..*
*.....*..*..*...........*..*..*..............*........*..............*.....*
****..****..****..*..*******..*************..*..****..*..*******..*******..*
*.....*...........*........*...........*..*..*..*.....*..*........*..*.....*
**********..*..*..*..*************..****..*..*..****..*******..*..*..****..*
*...........*..*..*........*..*........*..*........*..*..*.....*..*..*.....*
*..*******..****************..****..*..*..****..*..*..*..*..****..*..*..****
*..*.....*..*........*.....*..*..*..*..*........*..*..*..*.....*.....*.....*
*..*..*..*..****..*******..*..*..****..*******..****..*..*..****..*..*..*..*
*..*..*...........*...........*........*..*.....*..*.....*..*.....*..*..*..*
*..*******..****..*******..****..*..****..*..****..*..*..*******..*..****..*
*..*.....*.....*..............*..*........*........*..*.....*..*..*.....*..*
****..****..*******..*******..*******..****..**********..*..*..*..*..*******
*.................*........*........*........*..*..*.....*..*..*..*.....*..*
*..*******..*..*******..*..*..*******..****..*..*..****..****..*******..*..*
*..*........*........*..*..*.....*..*.....*..*...........*..*..*.....*.....*
*******..**********..*************..*..*..****..****..****..*..*..*******..*
*..............*.....*........*.....*..*..*........*........*..*.....*.....*
****..****..****..*..*..*******..*..**********..*******..****..*..*..****..*
*.....*.....*..*..*..*..*.....*..*..*.....*.....*........*..*.....*..*.....*
*******..*..*..*..*..*..****..****..****..**********..*..*..*******..*..****
*........*.....*..*..*.....*....................*.....*.....*.....*........*
*************..*..*******..*..*************..*..****..*..****..**********..*
*..............*.....*........*...........*..*..*.....*........*...........*
****************..**********..*..*..*******..*..*..**********..*******..*..*
*........*..*..*.....*..*........*.....*.....*...........*........*.....*..*
*..*******..*..*..****..*******..****..*..*..**********..*..*..****..****..*
*..*.....*........*..............*..*..*..*..*...........*..*..*..*..*..*..*
*..*..*..*..****..*..*..****..****..**********..*..**********..*..*..*..*..*
*.....*........*.....*..*..............*........*...........*..*........*..*
****************************************************************************
