*******************************************************************************************
*........*..*...........*.....*.................*.................*..*.....*.....*.....*..*
*..*******..****..*******..*************..****..*******..*..*..****..****..*..****..*..*..*
*.....*........*........*........*..*.....*...........*..*..*..............*........*.....*
*..*..*..*..**********..****..****..*..*..*..*******..*..*..****************..*..*..*..*..*
*..*.....*...........*........*..*.....*..*..*.....*..*..*...........*.....*..*..*..*..*..*
****..*..****************..*..*..*..*******..****..****..****..*..****..*******..*******..*
*.....*..*..*...........*..*..*..*.....*..*..*.....*..*.....*..*..*.................*..*..*
****..****..*..*..****..*..****..*******..*..*..****..****..**********..****..*******..*..*
*..*...........*..*.....*..*.....*...........*.....*.....*..*.....*........*.....*........*
*..****..*******..****..*..****..*******..*..****..****..*..*..*..****..*..*..*..**********
*..............*..*........*..*..*........*........*...........*........*..*..*.....*.....*
*..*..*..*..*..*************..*..**********..*..*..*..*..*..*..****..*..*..*..*******..****
*..*..*..*..*.....*..*...........*...........*..*.....*..*..*.....*..*..*..*.....*..*.....*
*..*..****..****..*..*******..*..****..****..****..*************..*************..*..*..*..*
*..*.....*..*..*..*.....*.....*........*.....*..*..*..*.......................*........*..*
*..*..****..*..*..****..*******..*..*..*..****..****..****..*******..**********..****..****
*..*..*.....*..*.................*..*..*.....*..*...........*.................*.....*..*..*
****..*..****..**********************..****..*..*..*..**********..*..****..****..****..*..*
*.....*..............*....................*..*.....*..*...........*..*.....*.....*........*
*******************************************************************************************
