****************************************************
*.....*.....*..*...........*.....*........*..*.....*
*..****..****..****..*..*******..*..*******..*..****
*.....*........*..*..*.....*.....*..............*..*
*..**********..*..*******..*..*************..*..*..*
*...........*..*..*...........*........*.....*.....*
*..*******..*..*..*..*..****..*..*..****..*******..*
*..*........*..*..*..*.....*.....*.....*........*..*
*..**********..*..*..*..****..****..*..*..*******..*
*.....*..*...........*..*.....*.....*.....*..*.....*
*..*..*..*..*..****************..*******..*..****..*
*..*..*..*..*.....*........*.....*...........*.....*
****..*..*..*..*..****..****..****************..****
*...........*..*..*.................*..............*
****..*..*..*..**********..*..*******..*..*..*..****
*.....*..*..*........*..*..*.....*.....*..*..*..*..*
*..*******..*..*..****..*******************..*..*..*
*..*.....*..*..*.....*..............*........*..*..*
*..*..*..*..****..*******..*..*..****..*..****..*..*
*..*..*.....*........*.....*..*..*.....*.....*.....*
****..*..****..*******..****..****..**********..****
*..*..*..*..*.....*..*..*........*..*...........*..*
*..*..****..*..****..*..*..*******..*************..*
*.....*........*..*.....*...........*........*.....*
*..****..*..****..**********..****..*..*******..****
*.....*..*..*..*..*.....*.....*...........*........*
****..*..*..*..*..****..****..*************..*******
*.....*..*..*...........*........*.....*...........*
*..****..****..*******..*..*******..****..*..****..*
*..*........*..*.....*..*..............*..*..*.....*
*************..****..*..****..*******..*..*..****..*
*.................*..*........*.....*..*..*..*.....*
**********..*******..*..****..*..****..*..*..*..****
*.................*.....*...........*.....*..*.....*
****************************************************
