****************************************************************************
*...........*...........*..*.....*........*..*..*..*.....*........*..*..*..*
*..****..*******..*..****..*..****..*******..*..*..*..*..****..*..*..*..*..*
*..*.....*........*..*........*..*........*........*..*........*.....*.....*
*******..****..*..*..****..****..*..**********..*******************..****..*
*..*........*..*..*.....*........*........*..*.....*..*...........*.....*..*
*..*..*******..*..*******..*..****..*..****..*..*..*..*..****..*..****..*..*
*.....*........*.....*..*..*..*.....*.....*.....*...........*..*..*..*.....*
****..*..****..****..*..****..*******..****..*************..*******..****..*
*........*........*..*.....*........*.....*..*..*.....*..*........*.....*..*
*..****..*******..*..*..**********..****..****..*..*..*..****..*..****..*..*
*.....*..*..*..*..*........*........*.....*..*..*..*..*..*..*..*..*........*
****..****..*..*..*******..*..****..*..****..*..*..****..*..****..****..*..*
*........*..*.....*........*..*.....*.....*........*...........*.....*..*..*
**********..*..*..*..****..*..*..****..*..****..**********..*..*..*..****..*
*..*.....*.....*..*..*.....*..*........*.....*..............*.....*..*..*..*
*..****..*..****..*..**********..*******..**********..*..*..****..****..*..*
*..............*..*..*..*.....*..*..*.....*..*.....*..*..*..*..*........*..*
****..*..*..*..*..****..****..*..*..*******..****..*..*******..*..****..*..*
*.....*..*..*..*.........................................*...........*.....*
****************************************************************************
