*******************
*...........*.....*
*..*..*..*.....*..*
*..*..*..*..*..*..*
*..*..*..*..*..*..*
*..*..*..*..*..*..*
*.....*..*..*.....*
*..*.....*.....*..*
*******************
