*******************
*.....*.....*.....*
*..*..*..*..*..*..*
*..*..*..*..*..*..*
*..*..*..*..*..*..*
*..*..*..*..*..*..*
*.....*..*..*.....*
*..*.....*.....*..*
*******************
