*******************************
*..........................*..*
*****...*****..****..*..****..*
*........*....................*
*..*..*.....****..****..**.*..*
*..*..*..*..*..*..*..*.....*..*
****..*..*...........*..*..****
*..*..*.....*..*.....*........*
*..*..*..****..****..*..*..**.*
*.....*..*........*..*........*
*..*..*..............*..*..*..*
*........*........*.....*..*..*
*..****..****..****..*..*..*..*
*.....*.....*..*.....*........*
*..*..*..*...........**..***..*
*..*..*..*..*..*..*..*........*
*..*..**..***..*..*..*..****..*
*..............*...........*..*
*..****..****..***..**..*.**..*
*..*.....*.....*..............*
*******************************
