**********************************************
*..*.....*.....*.................*...........*
*..*..****..****..*..*..*.**..*..*..*..****..*
*...........*.....*........*...........*.....*
*..****..*******..*.....****..****..**.*..****
*..*..*..*.....*.....*..*........*.....*.....*
*..*..****..*..*****...***..***..*..*..*..****
*...........*........*........*..*.....*.....*
*******..*..*..****.....*..****..****..*..****
*...........*.....*.....*..*.....*..*.....*..*
*..****..*******..*..*..**.*..**.*..****..*..*
*..*..*........*..*.....*....................*
*..*..*..*..****..**...**..*..*..*..*..*..****
*.....*..*.....*..*..*..*..*..*..*..*..*.....*
*..****..****..*..*.....*..****..*..****..*..*
*..*.....*.....*.....*..*..*..*..*..*.....*..*
*.....**********..*.....*..*..**.*..***..**..*
*..*..*.......................*.....*.....*..*
*..*..******.***..*..*..*..*..****..*..*.**..*
*.................*.....*..*.................*
**********************************************
