**********************************************
*..*.....*........*.....*........*...........*
*..*..*..*..****..*..*..*.**..*..*..*..****..*
*...........*.....*........*...........*.....*
*..****..*..****..*.....****..****..*..*..****
*..*..*........*.....*..*........*...........*
*..*..*..*..*..*****...***..***..*..*..*..****
*...........*........*........*..*.....*.....*
*******..*..*..****.....*..****..****..*..*..*
*...........*.....*.....*..*.....*..*.....*..*
*..****..*******..*..*..**.*..**.*..*..*..*..*
*..*..*........*..*.....*....................*
*..*..*..*..****..**...**..*..*..*..*..*..****
*.....*..*.....*..*..*..*..*..*..*..*..*.....*
*..****..****..*..*.....*..****..*..*..*..*..*
*..*.....*.....*.....*..*..*..*..*..*.....*..*
*.....*..*******..*.....*..*..**.*..*....**..*
*..*..*.......................*.....*.....*..*
*..*..*..***.***..*..*..*..*..****..*..*.**..*
*.................*.....*....................*
**********************************************
