*******************************
*..........................*..*
*************..****..*******..*
*........*........*...........*
*..*..*..*..****..****..****..*
*..*..*..*..*..*..*........*..*
****..*..*..*..****..****..****
*..*..*..*.....*..*..*........*
*..*..**********..*..****..****
*.....*...........*..*........*
*..*************..*..*******..*
*........*..*.....*..*..*..*..*
*..****..*..*..*******..*..*..*
*.....*.......................*
*..*..*******..*******..*..****
*..*..*........*..*..*..*.....*
*************..*..*..*..****..*
*..............*...........*..*
*..****..****..*******..****..*
*..*.....*.....*...........*..*
*******************************
