**********************************************
*..*.....*.....*.....*..*........*...........*
*..*..****..****..****..*******..*..*..****..*
*...........*.....*........*..*.....*..*.....*
*..****..*******..*..*..****..****..****..****
*..*..*..*.....*.....*..*........*.....*.....*
*..*..*******..****..**********..****..*******
*........*..*.................*..*.....*.....*
*******..*..*..****..****..****..****..*..****
*...........*.....*..*..*..*.....*..*.....*..*
*..****..*******..****..****..****..****..*..*
*..*..*........*..*.....*....................*
*..*..****..****..*..****..*..*..*..*..*..****
*.....*..*.....*..*..*..*..*..*..*..*..*.....*
*..****..****..*..*..*..*..****..*..****..*..*
*..*.....*.....*.....*..*..*..*..*..*.....*..*
*..*..**********..****..*..*..*************..*
*..*..*.......................*.....*.....*..*
*..*..**********..*..*..*..*******..*..****..*
*.................*..*..*..*.................*
**********************************************
